matter	问题；事情
What's the matter?	怎么了？出什么事了？
sore	疼痛的；酸痛的
have a cold	感冒
stomachache	胃痛；腹痛
have a stomachache	胃痛
foot	脚；足
neck	颈；脖子
stomach	胃；腹部
throat	咽喉；喉咙
fever	发烧
lie	躺，平躺
lie down	躺下
rest	放松；休息
cough	咳嗽
X-ray	X 射线；X 光
toothache	牙痛
take one's temperature	量体温
headache	头痛
have a fever	发烧
break	间歇；休息
take breaks (take a break)	休息
hurt	（使）疼痛；受伤
passenger	乘客；旅客
off	离开（某处）；不工作；从......去掉
get off	下车
to one's surprise	使......惊讶的；出乎......意料
onto	向；朝
trouble	问题；苦恼
hit	击；打
right away	立即；马上
get into	陷入；参与
herself	（she的反身代词）她自己
bandage	绷带；用绷带包扎
sick	生病的；有病的
knee	膝；膝盖
nosebleed	鼻出血
breathe	呼吸
sunburned	晒伤的
ourselves	（we的反身代词）我们自己
climber	登山者；攀登者
be used to	习惯于；适应于
risk	危险；风险；冒险
take risks	冒险
accident	（交通）事故；意外遭遇
situation	情况；状况
kilo	千克；公斤
rock	岩石
run out (of)	用尽；耗尽
knife	刀
cut off	切除
blood	血
mean	意思是；打算；意欲
get out of	离开；从......出来
importance	重要性；重要
decision	决定；抉择
control	限制；约束；管理
be in control of	掌管；管理
spirit	勇气；意志
death	死；死亡
give up	放弃
nurse	护士
Judy	朱迪（女名）
Nancy	南希（女名）
Mandy	曼迪（女名）
Aron Ralston	阿伦•罗尔斯顿
Utah	尤他州（美国）

clean up	打扫（或清除）干净
cheer	欢呼；喝彩
cheer up	（使）变得更高兴；振奋起来
give out	分发；散发
volunteer	义务做；自愿做；志愿者
come up with	想出；提出（主意、计划回答等）
put off	推迟
sign	标志；信号
notice	通知；通告；注意；注意到；意识到
hand out	分发
call up	打电话给（某人）；征召
used to	曾经；过去
lonely	孤独的；寂寞的
care for	照顾，非常喜欢
several	几个；数个；一些
strong	强烈的；强壮的
feeling	感觉；感触
satisfaction	满足；满意
joy	高兴；愉快
owner	物主；主人
try out	参加选拔；试用
journey	（由指长途）旅行；行程
raise	募集；征集
alone	独自；单独
repair	修理；修补
fix	修理；安装
fix up	修理；装饰
give away	赠送；捐赠
take after	（外貌或行为）像
broken	破损的；残缺的
wheel	车轮；车子
letter	信；函
Miss	女士；小姐
set up	建起；设立
disabled	丧失能力的；有残疾的
make a difference	影响；有作用
blind	瞎的；失明的
deaf	聋的
imagine	想象；设想
difficulty	困难；难题
open	开；打开
door	门
carry	拿；提；扛
train	训练；培训

rubbish	垃圾；废弃物
take out the rubbish	倒垃圾
fold	折叠；对折
sweep	扫；打扫
floor	地板
mess	杂乱；不整洁
throw	扔；掷
all the time	频繁；反复
neither	也不
shirt	衬衫
as soon as	一……就；尽快
pass	给；递；走过；通过
borrow	借；借用
lend	借给；借出
finger	手指
hate	厌恶；讨厌
chore	杂务；乏味无聊的工作
while	与...同时；当...的时候；而；然而
snack	点心；小吃；快餐
stress	精神压力；心理负担
waste	浪费；垃圾；浪费；滥用
in order to	目的是；为了
provide	提供；供应
anyway	而且；加之
depend	依靠；信赖
develop	发展；壮大
independence	独立
fairness	公正性；合理性
since	因为；既然
neighbor	邻居
take care of	照顾；处理
ill	有病；不舒服
drop	落下；掉下
independent	独立的；自主的
fair	合理的；公正的
unfair	不合理的；不公正的
Sandy	桑迪

allow	允许；准许
wrong	有毛病的；错误的
What's wrong	哪儿不舒服
midnight	午夜；子夜
look through	快速查看；浏览
guess	猜测；估计
deal	协议；交易
big deal	重要的事
work out	成功的发展；解决
get on with	和睦相处；关系良好
relation	关系；联系；交往
communication	交流；沟通
argue	争吵；争论
cloud	云；云朵
elder	年纪较长的
instead	代替；反而；却
whatever	任何；每一
nervous	焦虑的；担忧的
offer	主动提出；自愿给予
proper	正确的；恰当的
secondly	第二；其次
communicate	交流；沟通
explain	解释；说明
clear	清楚易懂的；晴朗的
copy	抄袭；模仿；复制；复印
return	归还；回来；返回
anymore	再也（不）；（不）再
member	成员；分子
pressure	压力
compete	竞争；对抗
opinion	意见；想法；看法
skill	技艺；技巧
typical	典型的
football	（美式）橄榄球；足球
cut out	删除；删去
quick	快的；迅速的；时间短暂的
continue	持续；继续存在的
compare	比较
compare...with	比较；对比
crazy	不理智的；疯狂的
push	鞭策；督促；推动
development	发展；发育；成长
cause	造成；引起
usual	通常的；寻常的
in one's opinion	依……看
perhaps	可能；大概；也许
Cathy	凯茜（女名）
Taylor	泰勒（姓）

rainstorm	暴风雨
alarm	闹钟
go off	（闹钟）发出响声
begin	开始
heavily	在很大程度上；大量的
suddenly	突然；忽然
pick up	接电话
strange	奇特的；奇怪的
storm	暴风雨
wind	风
light	光；光线；光亮
report	报道；公布
area	地域；地区
wood	木；木头
window	窗；窗户
flashlight	手电筒；火炬
match	火柴
beat	敲打；打败
against	倚；碰；撞
asleep	睡着
fall asleep	进入梦乡；睡着
rise	升起；增加；提高
fallen	倒下的；落下的
apart	分离；分开
have a look	看一看
icy	覆盖着冰的；冰冷的
kid	开玩笑；欺骗
realize	理解；领会；认识到
make one's way	前往；费力的前进
passage	章节；段落
pupil	学生
completely	彻底地；完全地
shocked	惊愕的；受震惊的
silence	沉默；缄默；无声
in silence	沉默；无声
recently	不久前；最近
take down	拆除；往下拽；记录
terrorist	恐怖主义者；恐怖分子
date	日期；日子
tower	塔；塔楼
at first	首先；最初
truth	实情；事实
Allen	艾伦（姓）
Martin Luther King	马丁•路德•金

shoot	射击；发射
stone	石头
weak	虚弱的；无力的
god	神；上帝
remind	提醒；使想起
bit	一点；小块
a little bit	有点；稍微
silly	愚蠢的；不明事理的
instead	代替；反而
turn...into	变成
object	物体；物品
hide	隐藏；隐蔽
tail	尾巴
magic	有魔力的；有神奇力量的
stick	棍；条
excite	使激动；使兴奋
Western	西方国家的；（尤指）欧美的；西方的
once upon	从前
stepsister	继姐（妹）
prince	王子
fall in love	爱上；喜欢上
fit	适合；合身
couple	（尤指）夫妻；两人；两件事物
smile	笑；微笑
marry	结婚
get married	结婚
gold	金子；金币；金色的
emperor	国王
silk	丝绸；丝织物
underwear	内衣
nobody	没有人；小人物
stupid	愚蠢的
cheat	欺骗；蒙骗；骗子
stepmother	继母
wife	妻子；太太
husband	丈夫
whole	全部的；整体的
scene	（戏剧或歌剧的）场；场景
moonlight	月光
shine	发光；照耀
bright	光亮地；明亮地；明亮的；光线充足的
ground	地；地面
lead	带路；领路
voice	声音
brave	勇敢的；无畏的
Claudia	克劳迪娅（女名）
Journey to the West	《西游记》
the Monkey King	美猴王
Sleeping Beauty	《睡美人》
Cinderella	《灰姑娘》
Little Red Riding Hood	《小红帽》
Hansel	《韩赛尔与格雷特》（《糖果屋》）

square	平方；正方形
meter	米；公尺
deep	深的；纵深的
desert	沙漠
population	人口；人口数量
Asia	亚洲
feel free	（可以）随便（做某事）
tour	旅行；旅游
tourist	旅行者；观光者
wall	墙
amazing	令人大为惊奇的；令人惊喜（或惊叹）的
ancient	古代的；古老的
protect	保护；防护
wide	宽的；宽阔的
as far as I know	就我所知
achievement	成就；成绩
southwestern	西南的；西南方向的
thick	厚的；浓的
include	包括；包含
freezing	极冷的；冰冻的
condition	条件；状况
take in	吸入；吞入（体内）
succeed	实现目标；成功
challenge	挑战；考验
in the face of	面对（问题、困难等）
achieve	达到；完成；成功
force	力；力量
nature	自然界；大自然
even though	即使；虽然
ocean	大海；海洋
the Pacific	太平洋
cm	厘米
weigh	重量是；称……的重量
birth	出生；诞生
at birth	出生时
up to	到达（某数量、程度等）；至多有；不多于
adult	成年的；成人的；成人；成年动物
bamboo	竹子
endangered	濒危的
research	研究；调查
keeper	饲养员；保管人
awake	醒着

treasure	珠宝；财富
island	岛
full of	满是……的；（有）大量的；（有）丰富的
classic	经典作品；名著
page	（书刊或纸张的）页，面，张
hurry	匆忙；赶快
hurry up	赶快；急忙（做某事）
due	预期；预订
ship	船
tool	工具
gun	枪；炮
mark	迹象；记号；分数；做记号；打分
sand	沙滩；沙
cannibal	食人肉者
towards	朝；向；对着
land	陆地；大地
fiction	小说
science fiction	科幻小说（或影片等）
technology	科技；工艺
French	法语
pop	流行音乐；流行乐曲
rock	摇滚乐
band	乐队
country music	乡村音乐
forever	永远
abroad	在国外；到国外
actually	真实的；事实上
ever since	自从
fan	迷；狂热爱好者
southern	南方的
modern	现代的；当代的
success	成功
belong	属于；归属
one another	互相
laughter	笑；笑声
beauty	美；美丽
million	一百万
record	唱片；记录；录制；录（音）
introduce	介绍；引见
line	行；排
Alex	亚历克斯（男名）
Garth Brooks	加思•布鲁克斯
the Beatles	披头士乐队（英国）
Treasure Island	《金银岛》
Alice in Wonderland	《爱丽丝梦游仙境》
Little Women	《小妇人》
Oliver Twist	《雾都孤儿》
Robinson Crusoe	《鲁滨逊漂流记》
Tom Sawyer	《汤姆•索亚历险记》
Harry Potter	《哈利•波特》
Nashville	纳什维尔（美国田纳西州府）
Tennessee	田纳西州（美国）
Country Music Hall of Fame	乡村音乐名人堂博物馆

amusement	娱乐；游戏
amusement park	游乐场
somewhere	在某处；到某处
camera	照相机；摄影机；摄像机
invention	发明；发明物
invent	发明；创造
unbelievable	难以置信的；不真实的
progress	进步；进展
rapid	迅速的；快速的
unusual	特别的；不寻常的
toilet	座便器；厕所
encourage	鼓励
social	社会的
peaceful	和平的；安宁的
tea art	茶艺
performance	表演；演出
perfect	完美的；完全的
tea set	茶具
itself	它自己（it的反身代词）
collect	收集；采集
a couple of	两个；一对；几个
German	德国的；德语的；德国人的；德语；德国人
theme	主题
ride	供乘骑的游乐设施；短途旅程
province	省份
thousand	一千
thousands of	数以千计的；许许多多的
on the one hand...on the other hand	一方面……另一方面……
safe	安全的；无危险的
simply	仅仅；只；不过
fear	害怕；惧怕
whether	不管……（还是）；或者……（或者）；是否
Indian	印度的；印度人
Japanese	日本的；日本人的；日语的；日本人；日语
fox	狐狸
all year round	全年
equator	赤道
whenever	在任何时候；无论何时
spring	春天
mostly	主要地；通常
location	地点；位置
National Science Museum	国家科学博物馆
International Toilet Museum	国际厕所博物馆
Hangzhou National Tea Museum	杭州国家茶博物馆
Donald Duck	唐老鸭
Disneyland	迪斯尼乐园
Disney Cruise	迪斯尼游轮
the Terracotta Army	兵马俑
the Bird's Nest	鸟巢
Singapore	新加坡
Southeast Asia	东南亚
Night Safari	夜间动物园

yard	院子
yard sale	庭院拍卖会
sweet	甜蜜的；甜的；含糖的
memory	记忆；回忆
cent	分；分币
toy	玩具
bear	熊
maker	生产者；制订者
bread maker	面包机
scarf	围巾；披巾；头巾
soft	软的；柔软的
soft toy	软体玩具；布绒玩具
check	检查；审查
check out	察看；观察
board	板；木板
board game	棋类游戏
junior	地位（或职位、级别）低下的
junior high school	初级中学
childhood	童年；幼年
consider	注视；仔细考虑
close to	几乎；接近
hold	拥有；抓住
clear out	清理；丢掉
bedroom	卧室
no longer	不再；不复
own	拥有；有
railway	铁路；铁道
part	离开；分开
part with	放弃；交出
certain	某种；某事；某人
as for	至于；关于
honest	诚实的；老实的
to be honest	说实在的
while	一段时间；一会儿
truthful	诚实的；真实的
hometown	家乡；故乡
nowadays	现今；现在；目前
search	搜索；搜查
among	在（其）中；之一
crayon	彩色铅笔（或粉笔、蜡笔）
shame	羞耻；羞愧；惭愧
regard	将……认为；把……视为
count	数数
century	百年；世纪
according	依据；按照
opposite	与……相对；在……对面；对面的；另一边的
especially	尤其；特别；格外